111111
100001
100101
100w01
100101
101111
