1111111111
1000000001
1101101011
1001001001
1111111101
1000000001
1010111101
1010010101
1011w10001
1111111111
