11111111111111111111
10000000000001000001
10101010101010101011
10101010101110100001
10101010100010110001
10101110111011110101
10100010000000100001
10111011111110001011
10000000110000101001
10111110100111101101
11100010000100001001
10111111101101111011
10101010101001011011
10100000000000000001
10100111000110000001
10100100000000011001
10100101110100011001
10100101w00100000001
11111111111111111111
