11111111111111111111
10000000000001000001
10101111111111111111
10000100000001w00001
10100000000001000001
10110100110111111001
10000110000001000001
10100010000000001111
10100011111111000001
10001010000100000001
11101010100100000001
10101011100110100001
10001010000000100001
10111011111111111001
10100010100100000001
10100000100100001111
10111111101111111001
10000000000000000001
11111111111111111111
