0000000000000000000000000000000000000000
0111000000000000000011111111111111111110
01w100000000000000001000000000000000t010
0101000000000000000010111111111111111110
0101000000000000000010100000000000000000
0101000000000000000010100000000000000000
0101000000000000000010100000000000000000
0101000000000000000010100000000000000000
0101000000000000000010100000000000000000
0101000000000000000010100000000000000000
0101000000000000000010100000000000000000
0101000000000000000010100000000000000000
0101000000000000000010100000000000000000
0101000000000000000010100000000000000000
0101000000000000000010100000000000000000
0101000000000000000010100000000000000000
0101000000000000000010100000000000000000
0101111111111111111110111111111111111110
010000000000000000000p000000000000000010
0111111111111111111110111111111111111010
0000000000000000000010100000000000001010
0000000000000000000010100000000000001010
0000000000000000000010100000000000001010
0000000000000000000010100000000000001010
0000000000000000000010100000000000001010
0000000000000000000010100000000000001010
0000000000000000000010100000000000001010
0000000000000000000010100000000000001010
0000000000000000000010100000000000001010
0000000000000000000010100000000000001010
0000000000000000000010100000000000001010
0000000000000000000010100000000000001010
0000000000000000000010100000000000001010
0000000000000000000010100000000000001010
0000000000000000000010100000000000001010
0000000000000000000010100000000000001010
0111111111111111111110100000000000001t10
010t000000000000000000100000000000001010
0111111111111111111111100000000000001110
0000000000000000000000000000000000000000
